8 8
OOOOOOOO
O**O**FO
OO**O**O
OO*O**OO
O******O
OO*O***O
O****O*O
OOOOOOOO
